

LLINN@BOX MINGW64 ~
$ cd Downloads

LLINN@BOX MINGW64 ~/Downloads
$ cd school/lab/gitlog
bash: cd: school/lab/gitlog: No such file or directory

LLINN@BOX MINGW64 ~/Downloads
$ cd school

LLINN@BOX MINGW64 ~/Downloads/school
$ cd lab1

LLINN@BOX MINGW64 ~/Downloads/school/lab1
$ cd gitlog

LLINN@BOX MINGW64 ~/Downloads/school/lab1/gitlog
$ git config --global user.name "unnamed299"
git config --global user.email "ar_li@kbtu.kz"

LLINN@BOX MINGW64 ~/Downloads/school/lab1/gitlog
$ git config --global init.defaultBranch main

LLINN@BOX MINGW64 ~/Downloads/school/lab1/gitlog
$ git config --global core.autocrlf true

LLINN@BOX MINGW64 ~/Downloads/school/lab1/gitlog
$ git config --global core.safecrlf warn

LLINN@BOX MINGW64 ~/Downloads/school/lab1/gitlog
$ mkdir work
cd work
touch hello.html

LLINN@BOX MINGW64 ~/Downloads/school/lab1/gitlog/work
$ git init
Initialized empty Git repository in C:/Users/leeme/Downloads/school/lab1/gitlog/work/.git/

LLINN@BOX MINGW64 ~/Downloads/school/lab1/gitlog/work (main)
$ git add hello.html
git commit -m "Initial Commit"
[main (root-commit) 77a9872] Initial Commit
 1 file changed, 0 insertions(+), 0 deletions(-)
 create mode 100644 hello.html

LLINN@BOX MINGW64 ~/Downloads/school/lab1/gitlog/work (main)
$ git status
On branch main
nothing to commit, working tree clean

LLINN@BOX MINGW64 ~/Downloads/school/lab1/gitlog/work (main)
$ git status
On branch main
Changes not staged for commit:
  (use "git add <file>..." to update what will be committed)
  (use "git restore <file>..." to discard changes in working directory)
        modified:   hello.html

no changes added to commit (use "git add" and/or "git commit -a")

LLINN@BOX MINGW64 ~/Downloads/school/lab1/gitlog/work (main)
$ git add hello.html
git status
On branch main
Changes to be committed:
  (use "git restore --staged <file>..." to unstage)
        modified:   hello.html


LLINN@BOX MINGW64 ~/Downloads/school/lab1/gitlog/work (main)
$ git add a.html
git add b.html
git commit -m "Changes for a and b"
fatal: pathspec 'a.html' did not match any files
fatal: pathspec 'b.html' did not match any files
[main 736eb21] Changes for a and b
 1 file changed, 1 insertion(+)

LLINN@BOX MINGW64 ~/Downloads/school/lab1/gitlog/work (main)
$ git commit
On branch main
nothing to commit, working tree clean

LLINN@BOX MINGW64 ~/Downloads/school/lab1/gitlog/work (main)
$ git status
On branch main
nothing to commit, working tree clean

LLINN@BOX MINGW64 ~/Downloads/school/lab1/gitlog/work (main)
$ git add hello.html

LLINN@BOX MINGW64 ~/Downloads/school/lab1/gitlog/work (main)
$ git status
On branch main
Changes to be committed:
  (use "git restore --staged <file>..." to unstage)
        modified:   hello.html


LLINN@BOX MINGW64 ~/Downloads/school/lab1/gitlog/work (main)
$ git commit -m "Added standard HTML page tags"
git status
[main 491ffcb] Added standard HTML page tags
 1 file changed, 5 insertions(+), 1 deletion(-)
On branch main
nothing to commit, working tree clean

LLINN@BOX MINGW64 ~/Downloads/school/lab1/gitlog/work (main)
$ git add .
git status
On branch main
nothing to commit, working tree clean

LLINN@BOX MINGW64 ~/Downloads/school/lab1/gitlog/work (main)
$ git commit -m "Added HTML header"
On branch main
nothing to commit, working tree clean

LLINN@BOX MINGW64 ~/Downloads/school/lab1/gitlog/work (main)
$ git log
commit 491ffcbf14aadba14addc9adb23166cbf3855f06 (HEAD -> main)
Author: unnamed299 <ar_li@kbtu.kz>
Date:   Thu Jan 16 05:46:03 2025 +0500

    Added standard HTML page tags

commit 736eb21d27cdff85e8ff78935517285e903e41c4
Author: unnamed299 <ar_li@kbtu.kz>
Date:   Thu Jan 16 05:44:53 2025 +0500

    Changes for a and b

commit 77a987257dec592c0ebeb08da1d74d60cd2d6578
Author: unnamed299 <ar_li@kbtu.kz>
Date:   Thu Jan 16 05:43:56 2025 +0500

    Initial Commit

LLINN@BOX MINGW64 ~/Downloads/school/lab1/gitlog/work (main)
$ git log --pretty=oneline
491ffcbf14aadba14addc9adb23166cbf3855f06 (HEAD -> main) Added standard HTML page tags
736eb21d27cdff85e8ff78935517285e903e41c4 Changes for a and b
77a987257dec592c0ebeb08da1d74d60cd2d6578 Initial Commit

LLINN@BOX MINGW64 ~/Downloads/school/lab1/gitlog/work (main)
$ git log --all --pretty=format:"%h %cd %s (%an)" --since="7 days ago"
491ffcb Thu Jan 16 05:46:03 2025 +0500 Added standard HTML page tags (unnamed299)
736eb21 Thu Jan 16 05:44:53 2025 +0500 Changes for a and b (unnamed299)
77a9872 Thu Jan 16 05:43:56 2025 +0500 Initial Commit (unnamed299)

LLINN@BOX MINGW64 ~/Downloads/school/lab1/gitlog/work (main)
$ git log --pretty=format:"%h %ad | %s%d [%an]" --date=short
491ffcb 2025-01-16 | Added standard HTML page tags (HEAD -> main) [unnamed299]
736eb21 2025-01-16 | Changes for a and b [unnamed299]
77a9872 2025-01-16 | Initial Commit [unnamed299]

LLINN@BOX MINGW64 ~/Downloads/school/lab1/gitlog/work (main)
$

LLINN@BOX MINGW64 ~/Downloads/school/lab1/gitlog/work (main)
$ git config --global format.pretty '%h %ad | %s%d [%an]'
git config --global log.date short

LLINN@BOX MINGW64 ~/Downloads/school/lab1/gitlog/work (main)
$ git log
491ffcb 2025-01-16 | Added standard HTML page tags (HEAD -> main) [unnamed299]
736eb21 2025-01-16 | Changes for a and b [unnamed299]
77a9872 2025-01-16 | Initial Commit [unnamed299]

LLINN@BOX MINGW64 ~/Downloads/school/lab1/gitlog/work (main)
$ git checkout <hash>
cat hello.html
bash: syntax error near unexpected token `newline'
<html>
    <body>
        <h1>hello world</h1>
    </body>
</html>
LLINN@BOX MINGW64 ~/Downloads/school/lab1/gitlog/work (main)
$ git switch main
cat hello.html
Already on 'main'
<html>
    <body>
        <h1>hello world</h1>
    </body>
</html>
LLINN@BOX MINGW64 ~/Downloads/school/lab1/gitlog/work (main)
$ git tag v1
git log
491ffcb 2025-01-16 | Added standard HTML page tags (HEAD -> main, tag: v1) [unnamed299]
736eb21 2025-01-16 | Changes for a and b [unnamed299]
77a9872 2025-01-16 | Initial Commit [unnamed299]

LLINN@BOX MINGW64 ~/Downloads/school/lab1/gitlog/work (main)
$ git checkout v1^
cat hello.html
Note: switching to 'v1^'.

You are in 'detached HEAD' state. You can look around, make experimental
changes and commit them, and you can discard any commits you make in this
state without impacting any branches by switching back to a branch.

If you want to create a new branch to retain commits you create, you may
do so (now or later) by using -c with the switch command. Example:

  git switch -c <new-branch-name>

Or undo this operation with:

  git switch -

Turn off this advice by setting config variable advice.detachedHead to false

HEAD is now at 736eb21 Changes for a and b
<h1>Hello world</h1>
LLINN@BOX MINGW64 ~/Downloads/school/lab1/gitlog/work ((736eb21...))
$ git tag v1-beta
git log
736eb21 2025-01-16 | Changes for a and b (HEAD, tag: v1-beta) [unnamed299]
77a9872 2025-01-16 | Initial Commit [unnamed299]

LLINN@BOX MINGW64 ~/Downloads/school/lab1/gitlog/work ((v1-beta))
$ git checkout v1
git checkout v1-beta
Previous HEAD position was 736eb21 Changes for a and b
HEAD is now at 491ffcb Added standard HTML page tags
Previous HEAD position was 491ffcb Added standard HTML page tags
HEAD is now at 736eb21 Changes for a and b

LLINN@BOX MINGW64 ~/Downloads/school/lab1/gitlog/work ((v1-beta))
$ git tag
v1
v1-beta

LLINN@BOX MINGW64 ~/Downloads/school/lab1/gitlog/work ((v1-beta))
$ git log main --all
491ffcb 2025-01-16 | Added standard HTML page tags (tag: v1, main) [unnamed299]
736eb21 2025-01-16 | Changes for a and b (HEAD, tag: v1-beta) [unnamed299]
77a9872 2025-01-16 | Initial Commit [unnamed299]

LLINN@BOX MINGW64 ~/Downloads/school/lab1/gitlog/work ((v1-beta))
$ git switch main
Previous HEAD position was 736eb21 Changes for a and b
Switched to branch 'main'

LLINN@BOX MINGW64 ~/Downloads/school/lab1/gitlog/work (main)
$ git status
On branch main
Changes not staged for commit:
  (use "git add <file>..." to update what will be committed)
  (use "git restore <file>..." to discard changes in working directory)
        modified:   hello.html

no changes added to commit (use "git add" and/or "git commit -a")

LLINN@BOX MINGW64 ~/Downloads/school/lab1/gitlog/work (main)
$ git checkout hello.html
git status
cat hello.html
Updated 1 path from the index
On branch main
nothing to commit, working tree clean
<html>
    <body>
        <h1>hello world</h1>
    </body>
</html>
LLINN@BOX MINGW64 ~/Downloads/school/lab1/gitlog/work (main)
$ git add hello.html

LLINN@BOX MINGW64 ~/Downloads/school/lab1/gitlog/work (main)
$ git status
On branch main
Changes to be committed:
  (use "git restore --staged <file>..." to unstage)
        modified:   hello.html


LLINN@BOX MINGW64 ~/Downloads/school/lab1/gitlog/work (main)
$ git reset HEAD hello.html
Unstaged changes after reset:
M       hello.html

LLINN@BOX MINGW64 ~/Downloads/school/lab1/gitlog/work (main)
$ git checkout hello.html
git status
Updated 1 path from the index
On branch main
nothing to commit, working tree clean

LLINN@BOX MINGW64 ~/Downloads/school/lab1/gitlog/work (main)
$ position was 736eb21 Changes for a and b
HEAD is now at 491ffcb Added standard HTML page tags
Previous HEAD position was 491ffcb Added standard HTML page tags
HEAD is now at 736eb21 Changes for a and b

LLINN@BOX MINGW64 ~/Downloads/school/lab1/gitlog/work ((v1-beta))
$ git tag
v1
v1-beta

LLINN@BOX MINGW64 ~/Downloads/school/lab1/gitlog/work ((v1-beta))
$ git log main --all
491ffcb 2025-01-16 | Added standard HTML page tags (tag: v1, main) [unnamed299]
736eb21 2025-01-16 | Changes for a and b (HEAD, tag: v1-beta) [unnamed299]
77a9872 2025-01-16 | Initial Commit [unnamed299]

LLINN@BOX MINGW64 ~/Downloads/school/lab1/gitlog/work ((v1-beta))
$ git switch main
Previous HEAD position was 736eb21 Changes for a and b
Switched to branch 'main'

LLINN@BOX MINGW64 ~/Downloads/school/lab1/gitlog/work (main)
$ git status
On branch main
Changes not staged for commit:
  (use "git add <file>..." to update what will be committed)
  (use "git restore <file>..." to discard changes in working directory)
        modified:   hello.html

no changes added to commit (use "git add" and/or "git commit -a")

LLINN@BOX MINGW64 ~/Downloads/school/lab1/gitlog/work (main)
$ git checkout hello.html
git status
cat hello.html
Updated 1 path from the index
On branch main
nothing to commit, working tree clean
<html>
    <body>
        <h1>hello world</h1>
    </body>
</html>
LLINN@BOX MINGW64 ~/Downloads/school/lab1/gitlog/work (main)
$ git add hello.html

LLINN@BOX MINGW64 ~/Downloads/school/lab1/gitlog/work (main)
$ git status
On branch main
Changes to be committed:
  (use "git restore --staged <file>..." to unstage)
        modified:   hello.html


LLINN@BOX MINGW64 ~/Downloads/school/lab1/gitlog/work (main)
$ git reset HEAD hello.html
Unstaged changes after reset:
^CINN@BOX MINGW64 ~/Downloads/school/lab1/gitlog/work (main)

LLINN@BOX MINGW64 ~/Downloads/school/lab1/gitlog/work (main)
$ ion was 736eb21 Changes for a and b
HEAD is now at 491ffcb Added standard HTML page tags
Previous HEAD position was 491ffcb Added standard HTML page tags
HEAD is now at 736eb21 Changes for a and b

LLINN@BOX MINGW64 ~/Downloads/school/lab1/gitlog/work ((v1-beta))
$ git tag
v1
v1-beta

LLINN@BOX MINGW64 ~/Downloads/school/lab1/gitlog/work ((v1-beta))
$ git log main --all
491ffcb 2025-01-16 | Added standard HTML page tags (tag: v1, main) [unnamed299]
736eb21 2025-01-16 | Changes for a and b (HEAD, tag: v1-beta) [unnamed299]
77a9872 2025-01-16 | Initial Commit [unnamed299]

LLINN@BOX MINGW64 ~/Downloads/school/lab1/gitlog/work ((v1-beta))
$ git switch main
Previous HEAD position was 736eb21 Changes for a and b
Switched to branch 'main'

LLINN@BOX MINGW64 ~/Downloads/school/lab1/gitlog/work (main)
$ git status
On branch main
Changes not staged for commit:
  (use "git add <file>..." to update what will be committed)
  (use "git restore <file>..." to discard changes in working directory)
        modified:   hello.html

no changes added to commit (use "git add" and/or "git commit -a")

LLINN@BOX MINGW64 ~/Downloads/school/lab1/gitlog/work (main)
$ git checkout hello.html
git status
$ ion was 736eb21 Changes for a and b
HEAD is now at 491ffcb Added standard HTML page tags
Previous HEAD position was 491ffcb Added standard HTML page tags
HEAD is now at 736eb21 Changes for a and b
<html>
LLINN@BOX MINGW64 ~/Downloads/school/lab1/gitlog/work ((v1-beta))
$ git tagh1>hello world</h1>
v1  </body>
v1-beta
LLINN@BOX MINGW64 ~/Downloads/school/lab1/gitlog/work (main)
LLINN@BOX MINGW64 ~/Downloads/school/lab1/gitlog/work ((v1-beta))
$ git log main --all
491ffcb 2025-01-16 | Added standard HTML page tags (tag: v1, main) [unnamed299]
736eb21 2025-01-16 | Changes for a and b (HEAD, tag: v1-beta) [unnamed299]
77a9872 2025-01-16 | Initial Commit [unnamed299]
Changes to be committed:
LLINN@BOX MINGW64 ~/Downloads/school/lab1/gitlog/work ((v1-beta))
$ git switch main   hello.html
Previous HEAD position was 736eb21 Changes for a and b
Switched to branch 'main'
LLINN@BOX MINGW64 ~/Downloads/school/lab1/gitlog/work (main)
LLINN@BOX MINGW64 ~/Downloads/school/lab1/gitlog/work (main)
$ git statusnges after reset:
On branch main
Unstaged changes after 